1111111111111
10100001000C1
10000001C00C1
10PC110000001
1000000011111
1000000000EC1
1111111111111